Machine_number=10
            Job_number=7
            AGV_number = 3
            AGV_weight = 2
            epk=[10,8,12,10,7,13,11,8,10,11]
             epik=[2,1,2,1,2,1,1,2,3,2]
            ea_unload = 3.5
            ea_load = 0.5
            ea_idle = 0.5
            P_time = [[
                [9999, 9999, 6, 4, 9999, 9999, 9999, 9999, 9999, 9999],
                [2, 3, 9999, 9999, 4, 9999, 9999, 9999, 9999, 9999],
                [4, 3, 3, 6, 9999, 4, 9999, 9999, 9999, 9999],
                [9999, 9999, 9999, 9999, 9999, 9999, 4, 3, 9999, 9999],
                [9999, 9999, 9999, 9999, 9999, 9999, 9999, 9999, 3, 5]
            ], [
                [9999, 9999, 3, 4, 9999, 9999, 9999, 9999, 9999, 9999],
                [2, 2, 4, 3, 9999, 9999, 9999, 9999, 9999, 9999],
                [3, 2, 9999, 9999, 4, 9999, 9999, 9999, 9999, 9999],
                [9999,   9999, 4, 6, 9999, 9999, 9999, 9999, 9999, 9999],
                [3, 3, 9999, 9999, 9999, 9999, 9999, 9999, 2, 4],
                [9999, 9999, 9999, 9999, 9999, 9999, 9999, 9999, 7, 8]

            ], [
                [5, 7, 9999, 9999, 9999, 9999, 9999, 9999, 9, 6],
                [3, 5, 9999, 9999, 3, 9999, 9999, 9999, 9999, 9999],
                [7, 5, 9999, 9999, 9999, 4, 9999, 9999, 9999, 9999],
                [3, 2, 2, 4, 9999, 9999, 9999, 9999, 9999, 9999],
                [9999, 9999, 9999, 9999, 9999, 9999, 6, 9, 9999, 9999],
                [9999, 9999, 9999, 9999, 9999, 4, 9999, 9999, 9999, 9999],
                [9999, 9999, 9999, 9999, 9999, 9999, 4, 7, 9999, 9999]
            ], [
                [4, 4, 3, 6, 9999, 9999, 9999, 9999, 9999, 9999],
                [9999, 9999, 9999, 9999, 9999, 9999, 9999, 9999, 9, 7],
                [2, 1, 9999, 9999, 3, 9999, 9999, 9999, 9999, 9999],
                [9999, 9999, 7, 6,7, 9999, 9999, 9999, 9999, 9999],
                [9999, 9999, 9999, 9999, 9999, 4, 9999, 9999, 9999, 9999],
                [3, 3, 9999, 9999, 9999, 9999, 9999, 9999, 4, 5]
            ], [
                [9999, 9999, 5, 6, 5, 9999, 9999, 9999, 9999, 9999],
                [3, 2, 9999, 9999, 2, 9999, 9999, 9999, 9999, 9999],
                [6, 6, 5, 8, 5, 9999, 9999, 9999, 9999, 9999],
                [9999, 9999, 9999, 9999, 9999, 9999, 9999, 9999, 2, 3],
                [9999, 9999, 9999, 9999, 9999, 9999, 4, 3, 9999, 9999],
                [3, 2, 9999, 9999, 2, 9999, 9999, 9999, 9999, 9999]

            ], [
                [3, 4, 9999, 9999, 9999, 9999, 9999, 9999, 5, 5],
                [9999, 9999, 9999, 9999, 9999, 9999, 4, 3, 9999, 9999],
                [9999, 9999, 9999, 9999, 9999, 3, 9999, 9999, 9999, 9999],
                [9999, 9999, 3, 4, 3, 9999, 9999, 9999, 9999, 9999],
                [9999, 9999, 9999, 9999, 9999, 9999, 9999, 9999, 4, 6],
                [3, 3, 2, 4, 9999, 9999, 9999, 9999, 9999, 9999],
                [9999, 9999, 9999, 9999, 9999, 9999, 3, 5, 9999, 9999]
            ], [
                [3, 3, 9999, 2, 9999, 9999, 9999, 9999, 4, 5],
                [3, 2, 9999, 9999, 3, 9999, 9999, 9999, 9999, 9999],
                [1, 9999, 2, 1, 9999, 9999, 9999, 9999, 9999, 9999],
                [9999, 9999, 4, 4, 3, 9999, 9999, 9999, 9999, 9999],
                [9999, 9999, 9999, 9999, 9999, 9999, 3, 4, 9999, 9999],
                [9999, 9999, 9999, 9999, 9999, 9999, 5, 4, 9999, 9999],
                [3, 4, 9999, 4, 9999, 9999, 9999, 9999, 3, 5]
            ]]

            AGV_Trans = [[0, 1.5, 3.9, 3.1, 3.3, 4.1, 4.6, 3.3, 3.7, 3.0, 3.3],
                         [1.5, 0, 2.4, 1.6, 1.8, 2.4, 3.1, 1.8, 2.2, 1.5, 1.8],
                         [3.9, 2.4, 0, 1.7, 1.5, 2.3, 2.2, 1.2, 1.0, 2.5, 2.2],
                         [3.1, 1.6, 1.7, 0, 1.0, 2.2, 2.8, 1.9, 1.2, 1.4, 1.2],
                         [3.3, 1.8, 1.5, 1.0, 0, 2.7, 2.4, 1.8, 1.6, 2.0, 1.8],
                         [4.1, 2.4, 2.3, 2.2, 2.7, 0, 1.8, 2.8, 2.6, 1.2, 3.0],
                         [4.6, 3.1, 2.2, 2.8, 2.4, 1.8, 0, 2.0, 2.3, 2.8, 2.6],
                         [3.3, 1.8, 1.2, 1.9, 1.8, 2.8, 2.0, 0, 1.0, 1.2, 1.4],
                         [3.7, 2.2, 1.0, 1.2, 1.6, 2.6, 2.3, 1.0, 0, 1.5, 1.7],
                         [3.0, 1.5, 2.5, 1.4, 2.0, 1.2, 2.3, 1.2, 1.5, 0, 1.1],
                         [3.3, 1.8, 2.2, 1.2, 1.8, 3.0, 2.6, 1.4, 1.7, 1.1, 0]
                         ]